########################
#..........##..........#
#.##.#####.##.#####.##.#
#......................#
#.##.#.#######.#.##.#..#
#....#....##....#....#.#
####.####.##.####.####.#
#....#..........#.#....#
###..#.##..##...#.##...#
#.......#..#.......#...#
####...########.#.####.#
#......#...P....#.#....#
####.####.##.####.####.#
#....#....##....#....#.#
#.##.#.#######.#.##.#..#
#..G........G.......G..#
#.##.#####.##.#####.##.#
#..........##..........#
########################